0XXXXXXXXXXXXXXXXXXXXXXXXXXXXXX0
0XXXXXXXXXXXXXXXXXXXXXXXXXXXXXX0
0XX111111111111##111111111111XX0
0XX1####1#####1##1#####1####1XX0
0XX2####1#####1##1#####1####2XX0
0XX1####1#####1##1#####1####1XX0
0XX11111111111111111111111111XX0
0XX1####1##1########1##1####1XX0
0XX1####1##1########1##1####1XX0
0XX111111##1111##1111##111111XX0
0XXXXXXX1#####0##0#####1XXXXXXX0
0XXXXXXX1#####0##0#####1XXXXXXX0
0000000X1##0000000000##1X0000000
0XXXXXXX1##0###**###0##1XXXXXXX0
0XXXXXXX1##0#000000#0##1XXXXXXX0
000000001000#000000#000100000000
0XXXXXXX1##0#000000#0##1XXXXXXX0
0XXXXXXX1##0########0##1XXXXXXX0
0000000X1##0000000000##1X0000000
0XXXXXXX1##0########0##1XXXXXXX0
0XXXXXXX1##0########0##1XXXXXXX0
0XX111111111111##111111111111XX0
0XX1####1#####1##1#####1####1XX0
0XX1####1#####1##1#####1####1XX0
0XX211##1111111001111111##112XX0
0XX##1##1##1########1##1##1##XX0
0XX##1##1##1########1##1##1##XX0
0XX111111##1111##1111##111111XX0
0XX1##########1##1##########1XX0
0XX1##########1##1##########1XX0
0XX11111111111111111111111111XX0
0XXXXXXXXXXXXXXXXXXXXXXXXXXXXXX0
0XXXXXXXXXXXXXXXXXXXXXXXXXXXXXX0