00000000000000000000000000000000
0##############################0
0##############################0
0##111111111111##111111111111##0
0##1####1#####1##1#####1####1##0
0##2####1#####1##1#####1####2##0
0##1####1#####1##1#####1####1##0
0##11111111111111111111111111##0
0##1####1##1########1##1####1##0
0##1####1##1########1##1####1##0
0##111111##1111##1111##111111##0
0#######1#####0##0#####1#######0
0#######1#####0##0#####1#######0
000000##1##0000000000##1##000000
0#######1##0###**###0##1#######0
0#######1##0###00###0##1#######0
W00000001000##0000##00010000000W
0#######1##0########0##1#######0
0#######1##0########0##1#######0
000000##1##0000000000##1##000000
0#######1##0########0##1#######0
0#######1##0########0##1#######0
0##111111111111##111111111111##0
0##1####1#####1##1#####1####1##0
0##1####1#####1##1#####1####1##0
0##211##1111111001111111##112##0
0####1##1##1########1##1##1####0
0####1##1##1########1##1##1####0
0##111111##1111##1111##111111##0
0##1##########1##1##########1##0
0##1##########1##1##########1##0
0##11111111111111111111111111##0
0##############################0
0##############################0
00000000000000000000000000000000